[console_scripts]
bashrc = handy.cli.simple:openbashrc
beautifyjson = handy.cli.json:beautify
boo = handy.cli.simple:shutdown
chkbashrc = handy.cli.simple:chkbashrc
chkey = handy.cli.json:chKey
chkstdin = handy.cli.filter:chkstdin
cls = handy.cli.simple:clear
colex = handy.cli.filter:colex
column = handy.cli.filter:column
commit = handy.cli.git:commit
concatstr = handy.cli.config:concatstr
crawlp = handy.cli.hack:crawlp
decode = handy.cli.crypt:Decode
decrypt = handy.cli.crypt:Decrypt
deline = handy.cli.text:deline
delkey = handy.cli.json:delKey
dirsize = handy.cli.chkinfo:dirsize
download = handy.cli.transfer:download
encode = handy.cli.crypt:Encode
encrypt = handy.cli.crypt:Encrypt
endstr = handy.cli.filter:endstr
excludestr = handy.cli.filter:excludestr
extractstr = handy.cli.filter:extractstr
findkey = handy.cli.json:findKey
findstr = handy.cli.filter:findstr
flush = handy.cli.simple:sourcebashrc
fromstr = handy.cli.filter:fromstr
genpass = handy.cli.crypt:genpazz
gps = handy.cli.chkinfo:gps
handy = handy.cli.cli:main
hash = handy.cli.crypt:hash
img2txt = handy.cli.hack:img2txt
ipinfo = handy.cli.chkinfo:ipinfo
lenstr = handy.cli.filter:lenstr
linecount = handy.cli.text:linecount
lowerstr = handy.cli.filter:lowerstr
mac = handy.cli.chkinfo:mac
oneline = handy.cli.text:oneline
printkey = handy.cli.json:printKey
prvip = handy.cli.chkinfo:privip
pubip = handy.cli.chkinfo:pubip
repl = handy.cli.text:replace
replconfkey = handy.cli.config:replconfkey
replconfval = handy.cli.config:replconfval
replkey = handy.cli.json:replKey
replvalue = handy.cli.json:replValue
rmempty = handy.cli.json:rmEmpty
rmlnno = handy.cli.filter:rmlnno
row = handy.cli.filter:row
rowcnt = handy.cli.filter:rowcnt
rowex = handy.cli.filter:rowex
srm = handy.cli.secure:srm
sumup = handy.cli.math:sum
timer = handy.cli.utils:timer
totalines = handy.cli.text:totalines
upload = handy.cli.transfer:upload
upperstr = handy.cli.filter:upperstr
version = handy.cli.chkinfo:version
wifipass = handy.cli.hack:wifipass
zh2ko = handy.cli.translate:zh2ko

